21 19 21 19 21 19 21 19 21 19 39 40 40 41 21 19 21 19 21 19 21 19 21 19
45 5 45 5 45 5 45 5 45 5 39 40 40 41 45 5 45 5 45 5 45 5 45 5
21 19 21 19 21 19 21 19 21 19 39 40 40 41 21 19 21 19 21 19 21 19 21 19
45 5 20 18 20 18 20 18 20 18 39 40 40 30 37 37 37 37 37 37 37 38 45 5
21 19 21 19 21 19 21 19 21 19 42 43 43 43 43 43 43 43 31 40 40 41 21 19
45 5 54 55 56 55 56 57 45 5 54 55 56 55 56 57 20 18 42 43 43 44 45 5
21 19 21 19 21 19 21 19 21 19 21 19 21 19 21 19 21 19 21 19 21 19 21 19
45 5 20 18 20 18 20 18 45 5 20 18 20 18 20 18 20 18 20 18 20 18 45 5
21 19 21 19 21 19 21 19 21 19 21 19 21 19 21 19 21 19 21 19 21 19 21 19
45 5 20 18 20 18 20 18 45 5 20 18 20 18 20 18 20 18 20 18 20 18 45 5
21 19 54 55 56 55 56 57 21 19 21 19 21 19 21 19 21 19 21 19 21 19 21 19
45 5 20 18 20 18 20 18 45 5 20 18 20 18 20 18 20 18 20 18 20 18 45 5
21 19 21 19 21 19 21 19 21 19 21 19 21 19 21 19 21 19 21 19 21 19 21 19
45 5 20 18 20 18 20 18 20 18 20 18 20 18 20 18 20 18 20 18 20 18 45 5
21 19 21 19 21 19 21 19 21 19 21 19 21 19 21 19 21 19 21 19 21 19 21 19
45 5 20 18 54 55 56 55 56 57 20 18 20 18 20 18 20 18 20 18 20 18 45 5
21 19 45 5 21 19 21 19 21 19 45 5 45 5 45 5 21 19 21 19 21 19 21 19
45 5 20 18 20 18 20 18 20 18 20 18 20 18 20 18 20 18 20 18 20 18 45 5